%%%%%%%%%%%%%%%%%%%%%%%%%%%%%%%
%.....%.................%.....%
%.%%%.%.%%%.%%%%%%%.%%%.%.....%
%.%...%.%......%......%.%.....%
%...%%%.%.%%%%.%.%%%%...%%%...%
%%%.%.%.%.%......%..%.%...%.%%%
%...%.%%%.%.%%% %%%.%.%%%.%...%
%.%%%...P...%     %.......%%%.%
%...%.%%%%%.%%%%%%%.%.%%%.%...%
%%%%%%%%%%%%%%%%%%%%%%%%%%%%%%%
